################
#..............#
#..##..........#
#..............#
#.......#......#
#.......#......#
#..............#
#..............#
#..............#
#..............#
#........#.....#
#.......##.....#
#..............#
#..............#
################
